W	T	W	W	W	|
W	G	G	G	W	|
W	G	W	G	W	|
W	G	W	H	W	|
W	G	D	Z	W	|
W	G	W	G	W	|
W	S	W	H	W	|
W	B	W	G	W	|
W	H	W	G	W	|
W	W	W	W	W	|
